404040404040
040404040404
000000000000
111110011111
222200002222
333000000333
333000000333
222200002222
111110011111
000000000000
000000000000
000000000000

