404040404040
040404040404
303030303030
030303030303
202020202020
020202020202
000000000000
111111111111
000000000000
111111111111
000000000000
000000000000

